35 35
00000000000000000000000000000000000
01111101011111110111110111011101110
01010001000000010100010100000101000
01011111110111011101111111111101110
01000000000100010101010100000001000
01110111110222010101010111111101110
00010101000202000000000001000001000
01110101122202010111110222220111010
01000001020002010100000201020100010
01122201020102220112222201022222110
00020200020100020002010100010002010
02220222221101122222010101110112010
02000100010000000101000001010002000
22011101011111010101110111010102010
00010001000100010001000000000102010
01010111011111010111010101111112220
01000100000100010000010100010100020
01011111011101111111111111010102220
01010000000000010000000000000102000
01111111110101110111111101010102220
01010100000101000001000101010101020
01010111111111111111011111111101022
01000000000100010001000001000000010
01110111011101010111110101011101010
00010001000001000100000101010001010
01110111011111011101010101111101110
00000001000101010101010101010100000
01011111011101110101111111010101110
01000101010000010000000101000001000
01111101110111010111010101111101110
01000000010100010100010100010000010
01011111111111010111110101010111110
01000000010000010101010001010100010
01011111111101111101011101111111010
00000000000000000000000000000000000
